BARCODE	CELL.TYPE
gcgcgggtcggctgcggt	Tissue_stem_cells
aattgggaggcccgagca	Tissue_stem_cells
cggcgtcgagcagccaga	Tissue_stem_cells
agcacgggccattcggga	Fibroblasts
tcgcctcgagcacaccac	Endothelial_cells
atacttcaggaggagctt	Endothelial_cells
tttgggaacgtggagctt	Tissue_stem_cells
gtggtgtcatcaggtagg	Endothelial_cells
agcacgctattatcatca	Chondrocytes
catagaccgatggcgcgg	Tissue_stem_cells
gcgaatgtcctaatccgg	Tissue_stem_cells
gcgcggaagccaggccat	Fibroblasts
ccacgcaattggatatac	Tissue_stem_cells
gactcgaaagaagatcaa	Endothelial_cells
gtcggctcatcaggattg	Fibroblasts
ctgtgggaggccagtaaa	Tissue_stem_cells
ccacgccaggagcctcta	Tissue_stem_cells
cttgaaatagcgtcatca	Smooth_muscle_cells
ccacgcctaggtcgaaag	Fibroblasts
aaagaagtggtgaagcca	Chondrocytes
attagttgcggttgcggt	Tissue_stem_cells
gaaggggtttcaaattgg	Fibroblasts
gctcccaattggccgatg	Tissue_stem_cells
atccggtcgcctatccgg	Smooth_muscle_cells
ctcaatgcgcggcttgaa	Chondrocytes
gccagaatgaagcgttat	Tissue_stem_cells
gccgtttggcagagtctg	Smooth_muscle_cells
gccagacgttatcggcgt	Tissue_stem_cells
caaccgggattgttcttg	Chondrocytes
atagcgaaagaatgctaa	Endothelial_cells
gctgaggagtgatggcag	Chondrocytes
catagaggccatagatgt	Tissue_stem_cells
caaccgctcaatccgtaa	Tissue_stem_cells
tctagcgccagagagtga	Tissue_stem_cells
cttacggaaatacaagtc	Tissue_stem_cells
tttgggcaggagcggtcc	Chondrocytes
gccagatctagctcgcct	Endothelial_cells
cgttatcgaaagggattg	Smooth_muscle_cells
ccacgcgcgcgggagctt	Tissue_stem_cells
gatcaactattatccaag	Tissue_stem_cells
cgagcacgcatatctagc	Fibroblasts
tgtgtatttgggaacgtg	Chondrocytes
gagtgatatttcttcgca	Tissue_stem_cells
ttaagaccacgcatgaag	Tissue_stem_cells
aacagcgcttgtgcgaat	Chondrocytes
cgttatagacccggtagg	Tissue_stem_cells
aggttagaggccttcttg	Tissue_stem_cells
tcagtgaacgtgaaagaa	Tissue_stem_cells
gccagaagtaaaaacagc	Chondrocytes
gatcaaatgaaggctccc	Tissue_stem_cells
ttcgcattaagagctccc	Fibroblasts
ctattacaaccgtgttcg	Tissue_stem_cells
atacttttggatacggac	Tissue_stem_cells
actgcaagatgtcaggag	Fibroblasts
caaccgagtaaataatag	Tissue_stem_cells
taccgatatttcattagt	Tissue_stem_cells
atagcgagatgtgcgcgg	Tissue_stem_cells
tgttcgtcatcacaggag	Chondrocytes
ccacgctcatcaactgca	Endothelial_cells
gtttcaggtaggaattgg	Fibroblasts
atccggagtctgcaggag	Smooth_muscle_cells
cgaaagagtaaacaggag	Fibroblasts
atgaaggaaatacagact	Chondrocytes
ttgctcatccggatatac	Fibroblasts
agtctgggtaggagtctg	Tissue_stem_cells
tttgggcgcataggtagg	Tissue_stem_cells
ctattacaggaggactcg	Tissue_stem_cells
tgtgtaagacccatactt	Tissue_stem_cells
gcgaatcaaccggccgtt	Tissue_stem_cells
gatcaagagcttcataga	Tissue_stem_cells
acccaacatagagcttgt	Tissue_stem_cells
tgcggtagcacgccacgc	Tissue_stem_cells
tgctaaaagtatctcaat	Tissue_stem_cells
gtggtgaagccaattagt	Chondrocytes
accttcagacccaccttc	Neurons
cagactagtaaagcgaat	Tissue_stem_cells
cggcgtatacttgaggcc	Tissue_stem_cells
actgcatcagtggtggtg	Fibroblasts
taagctctattatcatca	Tissue_stem_cells
ttcttgacaagggcgcgg	Chondrocytes
accttcactgcaatgaag	Tissue_stem_cells
agtctgccacgctgagac	Tissue_stem_cells
atgaagtgtgtatggcag	Tissue_stem_cells
cggcgtatactttgagac	Chondrocytes
ttcttgggattgttcgca	Fibroblasts
acaaggtaagctgtcggc	Tissue_stem_cells
tatttccgttatggattg	Endothelial_cells
ggccatatccgggactcg	Tissue_stem_cells
gagtgaagtaaaggattg	Fibroblasts
ctgtggtgttcgttgctc	Tissue_stem_cells
cggcgttggcagcgttat	Tissue_stem_cells
atataccaccacgtggtg	Fibroblasts
gagcttttcttgtgtgta	Tissue_stem_cells
ggattgttgctcgggatc	Tissue_stem_cells
ttggattgttcgatgaag	Fibroblasts
gaagggaaagaatgtgta	Fibroblasts
cggtccaagccaacggac	Tissue_stem_cells
agatgtggtaggaagcca	Smooth_muscle_cells
tgcggtcgagcagatcaa	Tissue_stem_cells
agacccatagcggggatc	Tissue_stem_cells
tagaggcaaccgccacgc	Tissue_stem_cells
tctagcgctccccaaccg	Tissue_stem_cells
caggagcaaccgtgcggt	Tissue_stem_cells
cagactggccatcaccac	Chondrocytes
ggccataacagcgtttca	Tissue_stem_cells
ttcttgaagtatggtagg	Tissue_stem_cells
tatttcagatgtcaagtc	Endothelial_cells
tcgggatctagccagact	Tissue_stem_cells
cttgaaacaaggtcatca	Tissue_stem_cells
atatacattagtagtaaa	Tissue_stem_cells
tgcggttgtgtaccgtaa	Tissue_stem_cells
gtacagtgcggttgagac	Tissue_stem_cells
tggcaggctccctcagtg	Tissue_stem_cells
gtcctattggatgagctt	Tissue_stem_cells
gccagaaagccagtggtg	Tissue_stem_cells
cagactatgaagatagcg	Tissue_stem_cells
cgttatcaagtcaagcca	Tissue_stem_cells
tgagacaccttccgcata	Smooth_muscle_cells
acaaggctaggttatttc	Tissue_stem_cells
gccgttgagcttcataga	Tissue_stem_cells
gcttgtgtggtgtttggg	Tissue_stem_cells
tcagtgtaagcttcatca	Tissue_stem_cells
ggtaggattagtcaagtc	Tissue_stem_cells
gctgaggtttcaatatac	Tissue_stem_cells
gttaacctgtggtcggga	Tissue_stem_cells
ggattgtatttcagtctg	Chondrocytes
cactgtgggatctgctaa	Tissue_stem_cells
ttaagatatttctaccga	Endothelial_cells
tgcggttagaggattagt	Macrophage
agcacgcagactgctccc	Fibroblasts
caagtccggtccctatta	Tissue_stem_cells
ggccatgctgagaacagc	Fibroblasts
gaaatagtggtgcggtcc	Tissue_stem_cells
caccacatgaagtatttc	Tissue_stem_cells
ttggattctagcgctgag	Tissue_stem_cells
ttggatctgtgggtcggc	Fibroblasts
gctgaggggatcggtagg	Tissue_stem_cells
cgagcaagtctgcgttat	Tissue_stem_cells
ttcttgatccggcaagtc	Tissue_stem_cells
gaagggaccttccactgt	Tissue_stem_cells
gactcgatacttttcgca	Tissue_stem_cells
gtggtgggattgtaagct	Smooth_muscle_cells
ttcgcatccaagagtctg	Tissue_stem_cells
gtcctaaattggagtctg	Tissue_stem_cells
gtttcaatgaagatagcg	Fibroblasts
ccacgcactgcaactgca	Endothelial_cells
gaagggcactgtctcaat	Tissue_stem_cells
gcgcgggtcctagaaata	Tissue_stem_cells
aggttagtttcactgtgg	Tissue_stem_cells
gcttgtaagccaccacgc	Tissue_stem_cells
aattggatatacggtagg	Tissue_stem_cells
ggtaggggccattaatag	Tissue_stem_cells
cagactgtttcagatcaa	Tissue_stem_cells
ttgctcagatgtgctgag	Endothelial_cells
atccgggagtgacttacg	Tissue_stem_cells
agacccaagccaggattg	Fibroblasts
cagactctgtggggtagg	Tissue_stem_cells
gaggccactgcaaattgg	Fibroblasts
tgtgtaattagtaaagaa	Tissue_stem_cells
cctctagggatcaccttc	Tissue_stem_cells
gggatcgggatccgaaag	Tissue_stem_cells
caagtctgtgtaggattg	Tissue_stem_cells
acccaaagatgtatccgg	Chondrocytes
agacccagtaaaaattgg	Tissue_stem_cells
gaagggcgcatataagct	Tissue_stem_cells
taccgaaaagaacgcata	Tissue_stem_cells
atgaagtgttcgctgtgg	Tissue_stem_cells
cggcgtgtacagaggtta	Tissue_stem_cells
cgttatgaggccggacga	Endothelial_cells
ccacgcggacgacagact	Tissue_stem_cells
tgctaaacaaggcggtcc	Tissue_stem_cells
tcagtgcggtccggtagg	Tissue_stem_cells
cactgtgagcttatccgg	Tissue_stem_cells
tagaggatccggagaccc	Tissue_stem_cells
aagccaatacttgccaga	Chondrocytes
gcgaataccttcatagcg	Tissue_stem_cells
tgttcgcttgaattgctc	Tissue_stem_cells
ctgtggtaatagtggcag	Tissue_stem_cells
acggacatccggtgcggt	Tissue_stem_cells
tagagggcttgtgtccta	Tissue_stem_cells
ttggatggccatatccgg	Smooth_muscle_cells
tccaagttggattatttc	Endothelial_cells
cttacggtggtgactgca	Tissue_stem_cells
gagctttgcggttaagct	Tissue_stem_cells
ccacgcccgatgcggcgt	Tissue_stem_cells
tgagaccaaccgtaccga	Tissue_stem_cells
cactgtggtgcttcatca	Chondrocytes
gaagggtgctaaaacgtg	Tissue_stem_cells
acccaaaacgtgacccaa	Tissue_stem_cells
tcgggataagctgatcaa	Tissue_stem_cells
gatcaatagagggatcaa	Tissue_stem_cells
atactttcatcaagtaaa	Tissue_stem_cells
aagccatatttctcagtg	Tissue_stem_cells
aattggtgaattcaagtc	Tissue_stem_cells
cactgtgtcctacaaccg	Tissue_stem_cells
cgcatagcttgtgagtga	Tissue_stem_cells
cagactgccagaacggac	Fibroblasts
gtcctacttgaacgcata	Tissue_stem_cells
ggtaggacccaaaacgtg	T_cells
tggcagtggcagacggac	Tissue_stem_cells
acggacctgtggtgttcg	Tissue_stem_cells
tagaggaccttcaccttc	Tissue_stem_cells
tccaagaagccacaccac	Smooth_muscle_cells
cgaaagagatgtgtccta	Tissue_stem_cells
ggccatccgtaaacggac	Fibroblasts
atacttcggcgtgaaata	Tissue_stem_cells
ggccatcaaccggaaggg	Tissue_stem_cells
caaccggaaatacaggag	Tissue_stem_cells
tgtgtatgctaaaccttc	Tissue_stem_cells
ggccatgtggtgtgtgta	Tissue_stem_cells
gtggtgtgttcgttaaga	Tissue_stem_cells
cagactttgctcttgctc	Tissue_stem_cells
aagccagagctttaatag	Chondrocytes
taagcttcagtgagaccc	Tissue_stem_cells
cctctaggattgcataga	Tissue_stem_cells
ccgatgcaaccgtgctaa	Tissue_stem_cells
acccaatggcagtaagct	Tissue_stem_cells
caggagcactgttcatca	Tissue_stem_cells
gaaataccgatgcataga	Tissue_stem_cells
tcgggacaaccggctgag	Tissue_stem_cells
gctgagtgtgtacagact	Tissue_stem_cells
agcacgttggatttcgca	Tissue_stem_cells
cctctaaggttactgtgg	Tissue_stem_cells
attagttagaggattagt	Tissue_stem_cells
gtcctaacccaagctccc	Tissue_stem_cells
cgagcaggtgctatagcg	Endothelial_cells
gccgttgaaggggagctt	Endothelial_cells
tagaggccgatgtgtgta	Tissue_stem_cells
tagaggttcttgggtgct	Tissue_stem_cells
tctagcttcttgtggcag	Tissue_stem_cells
gaggccgcgaatcttgaa	Tissue_stem_cells
gccgttcgaaagtcgcct	Fibroblasts
gcgcggggacgaggccat	Endothelial_cells
accttcactgcataatag	Tissue_stem_cells
ccgatggtcctagtttca	Tissue_stem_cells
agcacggctgagctcaat	Tissue_stem_cells
tgcggtcagactaaagaa	Endothelial_cells
gggatcaagccaggacga	Endothelial_cells
ttaagatatttccttacg	Smooth_muscle_cells
gtttcatgagaccaggag	Chondrocytes
atactttgcggtatgaag	Tissue_stem_cells
tcatcaagtctgaattgg	Tissue_stem_cells
ctaggtccacgcttaaga	Tissue_stem_cells
ggacgattggattaagct	Endothelial_cells
tggcagttcgcaacggac	Tissue_stem_cells
ttcttgctcaatttaaga	Fibroblasts
ccacgcccacgcccgtaa	Tissue_stem_cells
gactcgatatacgaggcc	Tissue_stem_cells
tgaattagcacgcataga	Tissue_stem_cells
cgagcagccagattcgca	Endothelial_cells
agcacgttcttggtcggc	Tissue_stem_cells
aggttagccagagccaga	Tissue_stem_cells
tatttccggcgtaaagaa	Smooth_muscle_cells
cggtccttaagacataga	Endothelial_cells
ttcgcacggcgtactgca	Chondrocytes
ggacgatatttctaagct	Tissue_stem_cells
gtggtgcagactcggtcc	Tissue_stem_cells
ctaggtcgcatatcgcct	Tissue_stem_cells
acaaggaacgtgggattg	Tissue_stem_cells
ttcttgaccttccgttat	Tissue_stem_cells
ctaggtcctctaagtctg	Chondrocytes
ctaggtgagtgaaagtat	Smooth_muscle_cells
gcttgttcgggatatttc	Tissue_stem_cells
cactgtatccggcgagca	Tissue_stem_cells
gaggccgcgcggctatta	Tissue_stem_cells
acggacaattggcagact	Tissue_stem_cells
atacttcttacgcagact	Tissue_stem_cells
gactcgactgcacgcata	Chondrocytes
tgagacctgtgggctccc	Tissue_stem_cells
cggcgttagagggctccc	Tissue_stem_cells
agtctgcaggagcggtcc	Tissue_stem_cells
agatgtgaagggccacgc	Tissue_stem_cells
gaggccgttaacagtaaa	Chondrocytes
aggttatgcggtgctccc	Tissue_stem_cells
gtacagtaataggtacag	Tissue_stem_cells
gtggtgactgcacgagca	Tissue_stem_cells
cctctagcgcggtagagg	Tissue_stem_cells
atgaagattagtgagtga	Chondrocytes
tccaagtaagctagatgt	Fibroblasts
atatactcatcacttacg	Tissue_stem_cells
atacttcagacttcagtg	Tissue_stem_cells
tggcagcggtccatatac	Tissue_stem_cells
gaggccggtaggtctagc	Endothelial_cells
catagaggtaggatccgg	Tissue_stem_cells
ctcaatcatagattgctc	Chondrocytes
gcgaatggacgatcagtg	Tissue_stem_cells
gagcttttgctcgtggtg	Tissue_stem_cells
atagcgtgttcgcgcata	Tissue_stem_cells
ctaggtctcaatcgaaag	Fibroblasts
tcagtgaattgggaaggg	Fibroblasts
cgcataccgtaattcgca	Tissue_stem_cells
acccaaagcacgttggat	Tissue_stem_cells
atacttgttaacaacgtg	Tissue_stem_cells
gactcgtatttccgaaag	Tissue_stem_cells
ggtgctagatgtgtcggc	Tissue_stem_cells
tcgggagaagggccacgc	Tissue_stem_cells
tgagactcgccttgagac	Tissue_stem_cells
tagaggagtaaaaacgtg	Tissue_stem_cells
tgtgtagtttcaagtaaa	Chondrocytes
atacttacccaacaagtc	Tissue_stem_cells
gctgaggagtgaaacgtg	Smooth_muscle_cells
gtcggcttaagaacaagg	Endothelial_cells
tgaattgggatcacccaa	Tissue_stem_cells
gggatcgactcgatccgg	Tissue_stem_cells
ttcttgacccaagagtga	Fibroblasts
aacgtgagcacgcaccac	Chondrocytes
tttgggtatttctttggg	Chondrocytes
acggactcgggagaaata	Chondrocytes
ggccataacgtgacggac	Tissue_stem_cells
atagcgtgtgtacggcgt	Tissue_stem_cells
aacagcgttaacgggatc	Fibroblasts
tgcggtctcaataagtat	Tissue_stem_cells
gaagggcttacgatgaag	Tissue_stem_cells
catagatcgggaaacagc	Tissue_stem_cells
tccaaggtcctagagtga	Tissue_stem_cells
agcacgaagtatttaaga	Smooth_muscle_cells
cagactactgcagtacag	Tissue_stem_cells
taccgagtcggccaagtc	Tissue_stem_cells
gtttcagaaataccacgc	Tissue_stem_cells
atacttaaagaatttggg	Tissue_stem_cells
ctaggtactgcaacggac	Tissue_stem_cells
cctctagaaataacggac	Fibroblasts
gtacagagcacgtggcag	Tissue_stem_cells
taatagccacgcacggac	Tissue_stem_cells
aagtatgccgttaattgg	Tissue_stem_cells
ttcgcacttacggcgaat	Tissue_stem_cells
ttcttgcttacgatactt	Tissue_stem_cells
gatcaagctgagatatac	Tissue_stem_cells
cagactcaccacacccaa	Tissue_stem_cells
ggccatgggatcgccaga	Fibroblasts
gagtgaccgatggaaggg	Fibroblasts
aaagaacagactgtggtg	Tissue_stem_cells
tgcggttgagacctaggt	Smooth_muscle_cells
attagtccgatgggccat	Chondrocytes
gactcggagtgatcagtg	Chondrocytes
atagcgatataccaagtc	Smooth_muscle_cells
aacagcctattacataga	Fibroblasts
ctaggttatttctttggg	Smooth_muscle_cells
gtcggcttgctcttcttg	Tissue_stem_cells
cgagcagatcaatagagg	Chondrocytes
taataggtttcaagtaaa	Fibroblasts
gggatccgttatgaaata	Endothelial_cells
cactgtaacgtggtacag	Tissue_stem_cells
agatgtgatcaagtttca	Monocyte
gtcctacgcatacaccac	Tissue_stem_cells
cttgaacactgtaccttc	Tissue_stem_cells
tgaattattagtaccttc	Tissue_stem_cells
gagcttcgaaagactgca	Fibroblasts
gcttgtccgtaacaccac	Tissue_stem_cells
caaccgagatgtgtcggc	Tissue_stem_cells
caggaggccagaattagt	Tissue_stem_cells
aagtatcaaccgtggcag	Fibroblasts
taataggccgtttcggga	Tissue_stem_cells
gctcccatagcgcctcta	Endothelial_cells
ttgctcgagtgaacggac	Smooth_muscle_cells
gccagagtcctagggatc	Fibroblasts
ttcgcacggcgttcgcct	Tissue_stem_cells
ctaggtggccatatccgg	Tissue_stem_cells
gaagggagaccctgttcg	Epithelial_cells
atagcgggccatttgctc	Epithelial_cells
ggtaggcctctatgttcg	Tissue_stem_cells
agtaaaacaaggtgaatt	Tissue_stem_cells
cggcgtgaggccggtgct	Fibroblasts
aagtattaccgatgttcg	Epithelial_cells
cttgaacggtccatactt	Epithelial_cells
cgcataatatacgctccc	Smooth_muscle_cells
ttggatgaaataggacga	Smooth_muscle_cells
caggagcgagcagttaac	Fibroblasts
gtacagcaaccggactcg	Smooth_muscle_cells
atgaaggactcgggacga	Smooth_muscle_cells
agtaaaaagtatggtagg	Fibroblasts
tgcggtcgaaagcggtcc	Fibroblasts
aagtataggttaggtgct	Tissue_stem_cells
acccaatgcggttctagc	Tissue_stem_cells
cgaaagcttacgggtgct	Fibroblasts
ggtgctggccatttaaga	Smooth_muscle_cells
gagcttccacgctctagc	Tissue_stem_cells
gaggcccttacgcgaaag	Tissue_stem_cells
caccacgaggccgaaata	Tissue_stem_cells
cgagcagtacagcagact	Tissue_stem_cells
atactttagaggttaaga	Smooth_muscle_cells
gccgtttgaatttcatca	Fibroblasts
cgcataaattgggccgtt	Epithelial_cells
aacgtgcaagtcccgatg	Fibroblasts
agcacgtcatcaaccttc	Epithelial_cells
ctaggttgtgtacataga	Fibroblasts
tcatcatggcaggcgaat	Smooth_muscle_cells
gaaggggcgaatctcaat	Tissue_stem_cells
gaaggggtcggcggacga	Monocyte
atccggtggcagagaccc	Monocyte
ttgctcaattggccacgc	Monocyte
tgaattactgcataatag	Epithelial_cells
cactgttaagctgtccta	Epithelial_cells
acccaacttacgccacgc	Tissue_stem_cells
gtggtgggacgaccacgc	Epithelial_cells
ttaagatcgcctgcgaat	Epithelial_cells
tgcggtaaagaagcttgt	Tissue_stem_cells
tttgggcctctactgtgg	Epithelial_cells
cttacgggtagggtggtg	Smooth_muscle_cells
agatgttgttcgggtagg	Fibroblasts
aggttacaaccgatagcg	Fibroblasts
cactgtcactgtcaccac	Monocyte
cggtccaagtatctatta	Fibroblasts
atagcgacccaactatta	Fibroblasts
gatcaatgctaagactcg	Epithelial_cells
agcacgttggatgaaata	Smooth_muscle_cells
cggcgtaattggcagact	Macrophage
cttgaattcttgggacga	Fibroblasts
ggacgaggattgttcttg	Epithelial_cells
acccaaagatgtccgatg	Epithelial_cells
gtggtggaagggcactgt	Fibroblasts
atagcgccgtaaatagcg	Smooth_muscle_cells
cctctagccgttggccat	Fibroblasts
ggtaggttcttgctatta	Epithelial_cells
tttggggaagggcttgaa	Tissue_stem_cells
gaagggggtagggcgaat	Macrophage
ttcgcaaggttaggtgct	Epithelial_cells
caaccgacccaacggcgt	Macrophage
atatacgctccccaagtc	Tissue_stem_cells
gccagactcaataggtta	Epithelial_cells
gcttgtctcaatgtttca	Epithelial_cells
tgtgtagtacagttcgca	Monocyte
tcgccttaccgatcggga	Macrophage
aggttacatagagccaga	Tissue_stem_cells
cagactctcaatggattg	Fibroblasts
gcgcgggactcgcaccac	Macrophage
gtttcacactgtttcttg	Epithelial_cells
tgctaagaggcccgagca	Macrophage
gaaggggccagacagact	NK_cell
gagtgaagtctgtggcag	Monocyte
gatcaaaggttatatttc	Tissue_stem_cells
caggagcctctataccga	Monocyte
cttgaaggtaggcactgt	Epithelial_cells
ggtgcttaagcttaagct	Tissue_stem_cells
tgcggttaatagtggcag	Tissue_stem_cells
aagccacgttatttggat	Monocyte
gccgttgtggtgacaagg	Epithelial_cells
caaccgaacagcacggac	Epithelial_cells
tcgggatgcggtaattgg	Tissue_stem_cells
ccacgctgagaccaagtc	Macrophage
caagtcagcacgctaggt	Epithelial_cells
ttggatggtgcttcatca	Macrophage
gggatcctattaaagcca	Tissue_stem_cells
tctagccaagtctgagac	Smooth_muscle_cells
gaggccgcgaatttcgca	Epithelial_cells
gatcaaagacccgtttca	Tissue_stem_cells
aagtatcactgtccgtaa	Epithelial_cells
tcatcacgcataatgaag	Tissue_stem_cells
catagatgctaacgagca	Tissue_stem_cells
gtcctacttgaactgtgg	Macrophage
gtttcaaacagctgaatt	Epithelial_cells
taatagtaccgaaacgtg	Chondrocytes
gcgaatgccgttcgcata	Tissue_stem_cells
cactgtcagactgctccc	Fibroblasts
atagcgatccggttcttg	Epithelial_cells
atacttgggatcgtttca	Tissue_stem_cells
gtcggctgagactgcggt	Macrophage
gaaataagatgtaaagaa	Fibroblasts
ggccatctgtgggaaggg	Monocyte
catagatcagtggagctt	Monocyte
gttaactaagctcaagtc	Epithelial_cells
agcacgtgcggtcttgaa	Tissue_stem_cells
ttcttgcggcgttaagct	Epithelial_cells
gttaactttggggtttca	Tissue_stem_cells
ggtgctaacagcggattg	Tissue_stem_cells
atactttccaagaagcca	Epithelial_cells
aattggtgctaagcgcgg	Macrophage
tcatcatcgcctttggat	Tissue_stem_cells
cgcatagcgaatcgttat	Epithelial_cells
aagccagtacagaattgg	Tissue_stem_cells
ttgctcttaagaggacga	Fibroblasts
actgcaacccaaggtgct	Tissue_stem_cells
attagttgagacagaccc	Tissue_stem_cells
cagactttcgcacgagca	Epithelial_cells
tatttctcgccttgttcg	Epithelial_cells
caaccgtcgcctaacgtg	Tissue_stem_cells
aagccacctctaatgaag	Macrophage
catagatgtgtaaaagaa	Tissue_stem_cells
tcagtgtcgcctgaaggg	Tissue_stem_cells
actgcatgttcgagcacg	Epithelial_cells
ttaagactaggtatgaag	Tissue_stem_cells
caagtcttggatcttacg	Epithelial_cells
aaagaaatatacttggat	Epithelial_cells
ggtaggttgctctcatca	NK_cell
atataccaggagtaagct	Fibroblasts
agtaaagtttcaatactt	Epithelial_cells
cgaaagggtgctttggat	Epithelial_cells
ctattaaccttcctaggt	Tissue_stem_cells
cactgtcctctaggccat	Tissue_stem_cells
ctaggtatacttaaagaa	Epithelial_cells
gcgaataggttatggcag	T_cells
gggatcgtttcacgttat	Epithelial_cells
cttacgggtaggatgaag	Epithelial_cells
ttcgcaatccgggactcg	Epithelial_cells
ttcttgcaggagatagcg	Endothelial_cells
agtaaagcgaatattagt	Tissue_stem_cells
tccaagtctagcggacga	Epithelial_cells
ttggatccgtaaagcacg	Tissue_stem_cells
aagccagtggtgtgtgta	Monocyte
taatagtcgggaaaagaa	Tissue_stem_cells
cggtcctttggggagtga	Epithelial_cells
agacccagcacgtcggga	Macrophage
cgaaagctgtggcggtcc	Fibroblasts
gtcctaaaagaacgaaag	Epithelial_cells
aggttacgagcaccacgc	Epithelial_cells
cagactcactgtcttacg	Tissue_stem_cells
gaggccacggaccgagca	Epithelial_cells
ttggatcaccacagtctg	DC
gtggtgacaagggtggtg	Macrophage
aagtattaagctctgtgg	Epithelial_cells
cctctaaggttaggccat	Tissue_stem_cells
tgagactgctaagatcaa	Epithelial_cells
tctagcgaggccaaagaa	Tissue_stem_cells
cgagcaatacttgcgaat	Epithelial_cells
taatagtatttcaacagc	Epithelial_cells
tgtgtaagcacgcttgaa	Epithelial_cells
taagctgccagactatta	Endothelial_cells
cgagcacatagaccgtaa	Tissue_stem_cells
agatgtcttacggggatc	Endothelial_cells
gagcttgccgtttcagtg	Macrophage
attagtcctctatatttc	Epithelial_cells
cgaaagttggatgccgtt	CMP
aattggtggcagtgaatt	Tissue_stem_cells
tcgcctttggatcttacg	Epithelial_cells
taagctgagcttctgtgg	Tissue_stem_cells
aaagaacggtccggtagg	Tissue_stem_cells
agtaaacgagcattcttg	Epithelial_cells
gcgcggatacttcttgaa	Endothelial_cells
gagcttcgcataagcacg	Epithelial_cells
cttgaagaagggaacgtg	Epithelial_cells
gagtgacaaccgacaagg	Tissue_stem_cells
aacagctagaggtctagc	Epithelial_cells
ttggatggtaggctcaat	Epithelial_cells
gagtgagttaacatactt	Epithelial_cells
gctgagggtaggcgagca	iPS_cells
tttgggatacttggccat	Epithelial_cells
atatacctattactgtgg	Tissue_stem_cells
agtctgttaagaaacagc	Endothelial_cells
caccacgaaatattgctc	Epithelial_cells
acggacgtggtgcataga	NK_cell
atgaagccacgctaagct	Epithelial_cells
taatagttgctctgtgta	B_cell
tgagaccctctagatcaa	Epithelial_cells
ctaggttgttcgctaggt	Epithelial_cells
tagagggccagaattagt	Epithelial_cells
ctaggtcactgtccgtaa	Epithelial_cells
gatcaagcttgtcgttat	Epithelial_cells
ggattggatcaagagtga	Epithelial_cells
cactgttgcggtaattgg	Epithelial_cells
tctagcgatcaacactgt	Epithelial_cells
ggacgacgaaagactgca	Epithelial_cells
